15 20
@@@@@@@@@@@@@@@
@@@@..@@@@@@@@@
@..........@@@@
@..........@@@@
@..........@@@@
@..........@@@@
@...........@@@
@...........@@@
@..........@@@@
@...........@@@
@..........@@@@
@..........@@@@
@@@....@@@@@@@@
@@@........@@@@
@@@........@@@@
@@@........@@@@
@@@........@@@@
@@@@@@@@@@@@@@@
@@@@@@@@@@@@@@@
@@@@@@@@@@@@@@@
3
-2 -2 -2 -2 -2 -2 -2 -2 -2 -2 -2 -2 -2 -2 -2 
-2 -2 -2 -2 0 0 -2 -2 -2 -2 -2 -2 -2 -2 -2 
-2 0 0 0 0 0 0 0 0 0 0 -2 -2 -2 -2 
-2 0 0 0 0 0 0 0 0 0 0 -2 -2 -2 -2 
-2 0 0 0 0 0 0 0 0 0 0 -2 -2 -2 -2 
-2 0 0 0 0 0 0 0 0 0 0 -2 -2 -2 -2 
-2 0 0 0 0 0 0 0 0 0 0 0 -2 -2 -2 
-2 0 0 0 0 0 0 0 0 0 0 0 -2 -2 -2 
-2 0 0 0 0 0 0 0 0 0 0 -2 -2 -2 -2 
-2 0 0 0 0 0 0 0 0 0 0 2 -2 -2 -2 
-2 0 0 0 0 0 0 0 0 0 0 -2 -2 -2 -2 
-2 0 0 0 0 0 0 0 0 0 0 -2 -2 -2 -2 
-2 -2 -2 0 0 0 0 -2 -2 -2 -2 -2 -2 -2 -2 
-2 -2 -2 1 1 1 1 1 1 1 1 -2 -2 -2 -2 
-2 -2 -2 1 1 1 1 1 1 1 1 -2 -2 -2 -2 
-2 -2 -2 1 1 1 1 1 1 1 1 -2 -2 -2 -2 
-2 -2 -2 1 1 1 1 1 1 1 1 -2 -2 -2 -2 
-2 -2 -2 -2 -2 -2 -2 -2 -2 -2 -2 -2 -2 -2 -2 
-2 -2 -2 -2 -2 -2 -2 -2 -2 -2 -2 -2 -2 -2 -2 
-2 -2 -2 -2 -2 -2 -2 -2 -2 -2 -2 -2 -2 -2 -2 
3
2 0 2 
1 1 
1 3 

4
0 0 3 12 2
1 1 1
2 8.2426 -1
1 1 3 13 1
0 1 -1
2 0 10 9 2
3 1 2
0 8.2426 -1
3 2 11 9 1
2 1 -1

3
2 2 1 
1 0 
1 0 

0

